###################################
#                #                #
#                #                #
#
#
#
#                #                #
#                #                #
#######       ###########         #
#                #      #         #
#                #      #         #
#                #      #         #
#                #      ###########
#                #                #
#                #
#                #                #
#                #                #
###################################