###################################
#                #                #
#                #                #
								  #
                                  #
##############                    #
#                #                #
#                #                #
#                ########         #
#                #                #
#                #      #         #
#                       #         #
##########       #############   ##
#                #                #
#                #
#                                 #
#                #                #
###################################